R  918 468
SO ./textures/wolf/stone2.xpm
NO ./textures/wolf/stone.xpm
EA ./textures/wolf/wood.xpm
WE ./textures/wolf/cave.xpm

S ./textures/wolf/spr_light.xpm
IA ./textures/wolf/guard.xpm
IAH ./textures/wolf/guard-hurt.xpm
IAD ./textures/wolf/guard-dead.xpm
DF ./textures/wolf/doorframe.xpm
DT ./textures/wolf/door.xpm
DFY ./textures/wolf/doorframe.xpm
DFR ./textures/wolf/doorframe.xpm
DY ./textures/wolf/door_y.xpm
DR ./textures/wolf/door_r.xpm
KY ./textures/wolf/key_y.xpm
KR ./textures/wolf/key_r.xpm
SS ./textures/wolf/spr_solid.xpm
CT ./textures/wolf/cub3d.xpm

F 112,112,112
C 56,56,56

0000000000000000000000000000111111111111111000000000000000000000
0000000000000000000000000000555555555555551000000000000000000000
0000033333300000000000000000500000000000051111100000000000000000
000003tqt03000000333333343335000000000o0055555100000000000000000
000003qtq03000000300000000005000v0000v000500t5100000000000000000
000003tqt0430000030200000200g0o0200002000g00r5100000000000000000
000003qtq00300000300000000005000000000000500t5100000000000000000
0000033433d334331300033343335000000000o0055555100000000000000000
000003t0000000q3130003111111555555g55555551111100000000000000000
000004000o200004330003311111111150005111111100000000000000000000
00000300v0000003000o00030000000050005000000000000000000000000000
000003000000000g000200o30000000050205000000000000000000000000000
0000030o0000v003000000030000000050005000000000000000000000000000
0000040000200004333433330000000050005000000000000000000000000000
333333q000o000t3000000000005555550005550000000000000000000000000
30u0333433g3343300000000000550do0020ov50000000000000000000000000
3qyq300030003000000000000005qt5550005550000000000000000000000000
3000300040204000000000000005tq5150005000000000000000000000000000
33g3333330003000000000000005qt5150005000000000000000000000000000
300030vt30003000000000000005555150205000000000000000000000000000
3020000o40204000000000000001111150005000000000000000000000000000
3000300q30003000000000000000000155g55100000000000000000000000000
3000333333g33333000000000033334300000343333000000000066666666660
400043o000000003000000000030000000000000003000000000060000000060
30003300000000040000000000400o000000000o004666666666660000000066
30003300v000v003000000000030000000v00000000600000000060000v0o0v6
3000030000000003000000000030002000200002000g0000o0000g0000000066
30200g000000000400000000003000v00000000v000600000000060000000066
3000030000000003000000000040000000000000004666000066660000v000v6
30003300v000v00300000000003q0000000000000o3111600611160000000066
30003300o000o004000000000033433300000334333111600610060o00q0t060
3000330000000003000000000000000166g66100000000600610066666666660
4000433333g33333000000000000000060006000000000600600000000000000
30o0333330003000000000000000000060006000000000600600000000000000
3000333330o03000000000000000000060006000000000600611616161611110
3000300t30203000000000000000000060206000000000600666t6o6q6o61110
3020000o40004000000000000000000060006000000000600060000000006110
30003v0q3000300000000000000000006000600000000060o0g00000000v6110
300033333o003000000000000000000060006000000000600060000000006110
3000333330003333333333433333433060006000000000666666q6o6t6o66000
30000o0000000000030000000400003060206000000000000011616161610000
30200000002000000g000200ol00a04060006000000000000000000000000000
3000000000000000030000000400003060006000000000000000000000000000
333333333343333333d333433333433060006000000000000000000000000000
000000000333ru350d0q50000006666666g66666660000000000000000000000
0000000003xm2030053q500000060000600060q0060000000000000000000000
0000000003330000035550000006q000g020g000060000000000000000000000
0000000000033d3333000000000600006000600v060000000000000000000000
0000000000003003000000000006t00060006000060000000000000000000000
00000000000033z3000000000006666660006666660000000000000000000000
0000000000003333000000000006000060006000060000000000000000000000
0000000000000000000000000006E00pg020g000060000000000000000000000
0000000000000000000000000006000060006000t60000000000000000000000
0000000000000000000000000006666660006666660000000000000000000000
0000000000000000000000000006000000000000060000000000000000000000
00000000000000000000000000060v20v020v02v060000000000000000000000
0000000000000000000000000006000000000000060000000000000000000000
0000000000000000000000000006666666666666660000000000000000000000